Script started on Sat Sep 25 15:48:54 2021

The default interactive shell is now zsh.
To update your account to use zsh, please run `chsh -s /bin/zsh`.
For more details, please visit https://support.apple.com/kb/HT208050.
[?1034hbash-3.2$ s[Kcomposer require symfony/apache-pack[C[C[C[C[C[C[C[C[C[Cls[Kphp -S localhost:8080 -t public/[C[C[C[C[C[C[C[C[C[C[C[C[C[C[Cs[C[C[C[C[C[C[C[C[C[C[C[C[C[C[C[C[C[C[C[C[C[C[C[C[C[C[C[C[C[C[C[C[C[C[C[C[C[C[C[C[CS[C[C[C[C[C[C[C[C[C[C[C[C[C[C[C[C[C[C[C[C[C[C[C[C[C[C[C[C[C[C[C[C[C[C[C[Cls[K
bin			composer.json		config			nbproject		public			symfony.lock		var
cache:clear		composer.lock		migrations		phpunit.xml.dist	src			templates		vendor
bash-3.2$ cacje[K[K[K[K[Kcls
bash: cls: command not found
bash-3.2$ cd ..
bash-3.2$ clear
[H[2Jbash-3.2$ ls
composer.phar	pruebaNivel
bash-3.2$ cd pruQ[KebaNivel/
bash-3.2$ LS
bin			composer.json		config			nbproject		public			symfony.lock		var
cache:clear		composer.lock		migrations		phpunit.xml.dist	src			templates		vendor
bash-3.2$ https://stackoverflow.com/questions/47611706/symfony-4-authenticationutils#:~:text=composer%20require%20security[K[K[K[K[K[K[K[K[K[K[K[K[K[K[K[K[K[K[K[K[K[K[K[K[K[K[K[K[K[K[K[K[K[K[K[K[K[K[K[K[K[K[K[K[K[K[K[K[K[K[K[K[K[K[K[K[K[K[K[K[K[K[K[K[K[K[K[K[K[K[K[K[K[K[K[K[K[K[K[K[K[K[K[K[K[K[K[K[K[K[K[K[K[K[K[K[K[K[K[K[K[K[K[K[K[K[K[K[K[K[K[Kcomposer require security
[32m./composer.json has been updated[39m
[32mRunning composer update symfony/security-bundle[39m
[32mLoading composer repositories with package information[39m
[32mUpdating dependencies[39m
Nothing to modify in lock file
[32mInstalling dependencies from lock file (including require-dev)[39m
Nothing to install, update or remove
[32mGenerating optimized autoload files[39m
[32mcomposer/package-versions-deprecated:[39m Generating version class...
[32mcomposer/package-versions-deprecated:[39m ...done generating version class
[32m110 packages you are using are looking for funding.[39m
[32mUse the `composer fund` command to find out more![39m

Run [33mcomposer recipes[39m at any time to see the status of your Symfony recipes.

Executing script cache:clear [32m[OK][39m
Executing script assets:install public [32m[OK][39m

bash-3.2$  php bin/console make:user

 [32mThe name of the security user class (e.g. [39m[33mUser[39m[32m)[39m [[33mUser[39m]:
 > 

 [32mDo you want to store user data in the database (via Doctrine)? (yes/no)[39m [[33myes[39m]:
 > 

 [32mEnter a property name that will be the unique "display" name for the user (e.g. [39m[33memail, username, uuid[39m[32m)[39m [[33memail[39m]:
 > eemi   mail

 Will this app need to hash/check user passwords? Choose [33mNo[39m if passwords are not needed or will be checked/hashed by some other system (e.g. a single sign-on server).

 [32mDoes this app need to hash/check user passwords? (yes/no)[39m [[33myes[39m]:
 > no


[37;41m                                                                                                                        [39;49m
[37;41m [ERROR] The file "src/Entity/User.php" can't be generated because it already exists.                                   [39;49m
[37;41m                                                                                                                        [39;49m

bash-3.2$  php bin/console make:user

 [32mThe name of the security user class (e.g. [39m[33mUser[39m[32m)[39m [[33mUser[39m]:
 > 

 [32mDo you want to store user data in the database (via Doctrine)? (yes/no)[39m [[33myes[39m]:
 > 

 [32mEnter a property name that will be the unique "display" name for the user (e.g. [39m[33memail, username, uuid[39m[32m)[39m [[33memail[39m]:
 > email

 Will this app need to hash/check user passwords? Choose [33mNo[39m if passwords are not needed or will be checked/hashed by some other system (e.g. a single sign-on server).

 [32mDoes this app need to hash/check user passwords? (yes/no)[39m [[33myes[39m]:
 > no  yes

 [34mcreated[39m: src/Entity/User.php
 [34mcreated[39m: src/Repository/UserRepository.php
 [33mupdated[39m: src/Entity/User.php

 [37;42m          [39;49m
 [37;42m Success! [39;49m
 [37;42m          [39;49m

 Next Steps:
   - Review your new [32mApp\Entity\User[39m class.
   - Use [33mmake:entity[39m to add more fields to your [32mUser[39m entity and then run [33mmake:migration[39m.
   - Your [32msecurity.yaml[39m could not be updated automatically. You'll need to add the following config manually:

security:
    password_hashers:
        App\Entity\User:
            algorithm: auto

    providers:
        # used to reload user from session & other features (e.g. switch_user)
        app_user_provider:
            entity:
                class: App\Entity\User
                property: email
   - Create a way to authenticate! See https://symfony.com/doc/current/security.html
bash-3.2$ make:entity
bash: make:entity: command not found
bash-3.2$ make:entitybmake:entityimake:entitynmake:entity/make:entitycmake:entityomake:entitynmake:entitysmake:entityomake:entitylmake:entityemake:entity make:entity

 [32mClass name of the entity to create or update (e.g. [39m[33mGentlePopsicle[39m[32m)[39m:
 > u[Ks[K[1D[K[1D[KU[K7[30;47mser[39;49m8s[K7[30;47mer[39;49m8e[K7[30;47mr[39;49m8r[K78

 Your entity already exists! So let's add some new fields!

 [32mNew property name (press [39m[32m<return>[39m[32m to stop adding fields)[39m:
 > Nombre

 [32mField type (enter [39m[33m?[39m[32m to see all types)[39m [[33mstring[39m]:
 > 1[K0[K0[K

[32mMain types[39m
  * [33mstring[39m
  * [33mtext[39m
  * [33mboolean[39m
  * [33minteger[39m (or [33msmallint[39m, [33mbigint[39m)
  * [33mfloat[39m

[32mRelationships / Associations[39m
  * [33mrelation[39m (a wizard 🧙 will help you build the relation)
  * [33mManyToOne[39m
  * [33mOneToMany[39m
  * [33mManyToMany[39m
  * [33mOneToOne[39m

[32mArray/Object Types[39m
  * [33marray[39m (or [33msimple_array[39m)
  * [33mjson[39m
  * [33mobject[39m
  * [33mbinary[39m
  * [33mblob[39m

[32mDate/Time Types[39m
  * [33mdatetime[39m (or [33mdatetime_immutable[39m)
  * [33mdatetimetz[39m (or [33mdatetimetz_immutable[39m)
  * [33mdate[39m (or [33mdate_immutable[39m)
  * [33mtime[39m (or [33mtime_immutable[39m)
  * [33mdateinterval[39m

[32mOther Types[39m
  * [33mascii_string[39m
  * [33mdecimal[39m
  * [33mguid[39m
  * [33mjson_array[39m

[37;41m                                                                                                                        [39;49m
[37;41m [ERROR] Invalid type "100".                                                                                            [39;49m
[37;41m                                                                                                                        [39;49m


 [32mField type (enter [39m[33m?[39m[32m to see all types)[39m [[33mstring[39m]:
 > [K7[30;47mrelation[39;49m8[K[K[K

 [32mField length[39m [[33m255[39m]:
 > 100

 [32mCan this field be null in the database (nullable) (yes/no)[39m [[33mno[39m]:
 > yes

 [33mupdated[39m: src/Entity/User.php

 [32mAdd another property? Enter the property name (or press [39m[32m<return>[39m[32m to stop adding fields)[39m:
 > telefono        roles


[37;41m                                                                                                                        [39;49m
[37;41m [ERROR] The "roles" property already exists.                                                                           [39;49m
[37;41m                                                                                                                        [39;49m

 [32mAdd another property? Enter the property name (or press [39m[32m<return>[39m[32m to stop adding fields)[39m:
 > 


 [37;42m          [39;49m
 [37;42m Success! [39;49m
 [37;42m          [39;49m

 Next: When you're ready, create a migration with [32mphp bin/console make:migration[39m
 
bash-3.2$ cls[K[K[K json_array[K[K[K[K[K[K[K[K[K[Kbin/console make:migration

[30;43m                                                                                                                        [39;49m
[30;43m [WARNING] You have 3 previously executed migrations in the database that are not registered migrations.                [39;49m
[30;43m                                                                                                                        [39;49m

 [32mAre you sure you wish to continue? (yes/no)[39m [[33myes[39m]:
 > yes


 [37;42m          [39;49m
 [37;42m Success! [39;49m
 [37;42m          [39;49m

 Next: Review the new migration [32m"[39m[32mmigrations/Version20210925144946.php[39m[32m"[39m
 Then: Run the migration with [32mphp bin/console doctrine:migrations:migrate[39m
 See [33mhttps://symfony.com/doc/current/bundles/DoctrineMigrationsBundle/index.html[39m
bash-3.2$  php bin/console doctrine:migrations:migrate


 [32mWARNING! You are about to execute a migration in database "pnbbdd" that could result in schema changes and data loss. Are you sure you wish to continue? (yes/no)[39m [[33myes[39m]:
 > 
[30;43m                                                                                                                        [39;49m
[30;43m [WARNING] You have 3 previously executed migrations in the database that are not registered migrations.                [39;49m
[30;43m                                                                                                                        [39;49m

 [33m>>[39m 2021-09-23 15:36:15 ([33mDoctrineMigrations\Version20210922213654[39m)
 [33m>>[39m 2021-09-23 15:36:15 ([33mDoctrineMigrations\Version20210923153518[39m)
 [33m>>[39m 2021-09-23 21:09:46 ([33mDoctrineMigrations\Version20210923210932[39m)

 [32mAre you sure you wish to continue? (yes/no)[39m [[33myes[39m]:
 > yes

[32m[notice] Migrating [39m[33mup[39m[32m to [39m[33mDoctrineMigrations\Version20210925144946[39m
[32m[notice] finished in [39m[33m852[39m[32mms, used [39m[33m20M[39m[32m memory, [39m[33m1[39m[32m migrations executed, [39m[33m1[39m[32m sql queries[39m

bash-3.2$ composer require symfony/security-bundle
[32m./composer.json has been updated[39m
[32mRunning composer update symfony/security-bundle[39m
[32mLoading composer repositories with package information[39m
[32mUpdating dependencies[39m
Nothing to modify in lock file
[32mInstalling dependencies from lock file (including require-dev)[39m
Nothing to install, update or remove
[32mGenerating optimized autoload files[39m
[32mcomposer/package-versions-deprecated:[39m Generating version class...
[32mcomposer/package-versions-deprecated:[39m ...done generating version class
[32m110 packages you are using are looking for funding.[39m
[32mUse the `composer fund` command to find out more![39m

Run [33mcomposer recipes[39m at any time to see the status of your Symfony recipes.

Executing script cache:clear [32m[OK][39m
Executing script assets:install public [32m[OK][39m

bash-3.2$ composer require symfony/security-bundle
^X^C
[37;41mInstallation failed, reverting ./composer.json and ./composer.lock to their original content.[39;49m
bash-3.2$  php bin/console config:dump-reference security

# Default configuration for extension with alias: "security"
security:
    access_denied_url:    null # Example: /foo/error403
    session_fixation_strategy: migrate # One of "none"; "migrate"; "invalidate"
    hide_user_not_found:  true
    always_authenticate_before_granting: false
    erase_credentials:    true

    # Enables the new Symfony Security system based on Authenticators, all used authenticators must support this before enabling this.
    enable_authenticator_manager: false
    access_decision_manager:
        strategy:             ~ # One of "affirmative"; "consensus"; "unanimous"; "priority"
        service:              ~
        allow_if_all_abstain: false
        allow_if_equal_granted_denied: true
    encoders:

        # Examples:
        App\Entity\User1:    auto
        App\Entity\User2:    { algorithm: auto, time_cost: 8, cost: 13 }

        # Prototype
        class:
            algorithm:            ~
            migrate_from:         []

            # Name of hashing algorithm for PBKDF2 (i.e. sha256, sha512, etc..) See hash_algos() for a list of supported algorithms.
            hash_algorithm:       sha512
            key_length:           40
            ignore_case:          false
            encode_as_base64:     true
            iterations:           5000
            cost:                 null
            memory_cost:          null
            time_cost:            null
            id:                   ~
    password_hashers:

        # Examples:
        App\Entity\User1:    auto
        App\Entity\User2:    { algorithm: auto, time_cost: 8, cost: 13 }

        # Prototype
        class:
            algorithm:            ~
            migrate_from:         []

            # Name of hashing algorithm for PBKDF2 (i.e. sha256, sha512, etc..) See hash_algos() for a list of supported algorithms.
            hash_algorithm:       sha512
            key_length:           40
            ignore_case:          false
            encode_as_base64:     true
            iterations:           5000
            cost:                 null
            memory_cost:          null
            time_cost:            null
            id:                   ~
    providers:

        # Examples:
        my_memory_provider:  { memory: { users: { foo: { password: foo, roles: ROLE_USER }, bar: { password: bar, roles: '[ROLE_USER, ROLE_ADMIN]' } } } }
        my_entity_provider:  { entity: { class: 'SecurityBundle:User', property: username } }

        # Prototype
        name:
            id:                   ~
            chain:
                providers:            []
            entity:

                # The full entity class name of your user class.
                class:                ~ # Required
                property:             null
                manager_name:         null
            memory:
                users:

                    # Prototype
                    identifier:
                        password:             null
                        roles:                []
            ldap:
                service:              ldap # Required
                base_dn:              ~ # Required
                search_dn:            null
                search_password:      null
                extra_fields:         []
                default_roles:        []
                uid_key:              sAMAccountName
                filter:               '({uid_key}={username})'
                password_attribute:   null
    firewalls:            # Required

        # Prototype
        name:
            pattern:              ~
            host:                 ~
            methods:              []
            security:             true

            # The UserChecker to use when authenticating users in this firewall.
            user_checker:         security.user_checker
            request_matcher:      ~
            access_denied_url:    ~
            access_denied_handler: ~

            # An enabled authenticator name or a service id that implements "Symfony\Component\Security\Http\EntryPoint\AuthenticationEntryPointInterface"
            entry_point:          ~
            provider:             ~
            stateless:            false
            lazy:                 false
            context:              ~
            logout:
                csrf_parameter:       _csrf_token
                csrf_token_generator: ~
                csrf_token_id:        logout
                path:                 /logout
                target:               /
                success_handler:      ~ # Deprecated (Since symfony/security-bundle 5.1: The "success_handler" at path "security.firewalls..logout" is deprecated, register a listener on the "Symfony\Component\Security\Http\Event\LogoutEvent" event instead.)
                invalidate_session:   true
                delete_cookies:

                    # Prototype
                    name:
                        path:                 null
                        domain:               null
                        secure:               false
                        samesite:             null
                handlers:             []
            switch_user:
                provider:             ~
                parameter:            _switch_user
                role:                 ROLE_ALLOWED_TO_SWITCH

            # A list of badges that must be present on the authenticated passport.
            required_badges:      []
            x509:
                provider:             ~
                user:                 SSL_CLIENT_S_DN_Email
                credentials:          SSL_CLIENT_S_DN
            remote_user:
                provider:             ~
                user:                 REMOTE_USER
            guard:

                # A key from the "providers" section of your security config, in case your user provider is different than the firewall
                provider:             ~

                # A service id (of one of your authenticators) whose start() method should be called when an anonymous user hits a page that requires authentication
                entry_point:          null

                # An array of service ids for all of your "authenticators"
                authenticators:       []

            # An array of service ids for all of your "authenticators"
            custom_authenticators: []
            login_throttling:

                # A service id implementing "Symfony\Component\HttpFoundation\RateLimiter\RequestRateLimiterInterface".
                limiter:              ~
                max_attempts:         5
                interval:             '1 minute'

                # The service ID of the lock factory used by the login rate limiter (or null to disable locking)
                lock_factory:         null
            form_login:
                provider:             ~
                remember_me:          true
                success_handler:      ~
                failure_handler:      ~
                check_path:           /login_check
                use_forward:          false
                require_previous_session: false
                login_path:           /login
                username_parameter:   _username
                password_parameter:   _password
                csrf_parameter:       _csrf_token
                csrf_token_id:        authenticate
                enable_csrf:          false
                post_only:            true
                always_use_default_target_path: false
                default_target_path:  /
                target_path_parameter: _target_path
                use_referer:          false
                failure_path:         null
                failure_forward:      false
                failure_path_parameter: _failure_path
                csrf_token_generator: ~
            form_login_ldap:
                provider:             ~
                remember_me:          true
                success_handler:      ~
                failure_handler:      ~
                check_path:           /login_check
                use_forward:          false
                require_previous_session: false
                login_path:           /login
                username_parameter:   _username
                password_parameter:   _password
                csrf_parameter:       _csrf_token
                csrf_token_id:        authenticate
                enable_csrf:          false
                post_only:            true
                always_use_default_target_path: false
                default_target_path:  /
                target_path_parameter: _target_path
                use_referer:          false
                failure_path:         null
                failure_forward:      false
                failure_path_parameter: _failure_path
                csrf_token_generator: ~
                service:              ldap
                dn_string:            '{username}'
                query_string:         ~
                search_dn:            ''
                search_password:      ''
            json_login:
                provider:             ~
                remember_me:          true
                success_handler:      ~
                failure_handler:      ~
                check_path:           /login_check
                use_forward:          false
                require_previous_session: false
                login_path:           /login
                username_path:        username
                password_path:        password
            json_login_ldap:
                provider:             ~
                remember_me:          true
                success_handler:      ~
                failure_handler:      ~
                check_path:           /login_check
                use_forward:          false
                require_previous_session: false
                login_path:           /login
                username_path:        username
                password_path:        password
                service:              ldap
                dn_string:            '{username}'
                query_string:         ~
                search_dn:            ''
                search_password:      ''
            login_link:

                # Route that will validate the login link - e.g. "app_login_link_verify".
                check_route:          ~ # Required

                # If true, only HTTP POST requests to "check_route" will be handled by the authenticator.
                check_post_only:      false

                # An array of properties on your User that are used to sign the link. If any of these change, all existing links will become invalid.
                signature_properties: # Required

                    # Examples:
                    - email
                    - password

                # The lifetime of the login link in seconds.
                lifetime:             600

                # Max number of times a login link can be used - null means unlimited within lifetime.
                max_uses:             null

                # Cache service id used to expired links of max_uses is set.
                used_link_cache:      ~

                # A service id that implements Symfony\Component\Security\Http\Authentication\AuthenticationSuccessHandlerInterface.
                success_handler:      ~

                # A service id that implements Symfony\Component\Security\Http\Authentication\AuthenticationFailureHandlerInterface.
                failure_handler:      ~

                # The user provider to load users from.
                provider:             ~
                always_use_default_target_path: false
                default_target_path:  /
                login_path:           /login
                target_path_parameter: _target_path
                use_referer:          false
                failure_path:         null
                failure_forward:      false
                failure_path_parameter: _failure_path
            http_basic:
                provider:             ~
                realm:                'Secured Area'
            http_basic_ldap:
                provider:             ~
                realm:                'Secured Area'
                service:              ldap
                dn_string:            '{username}'
                query_string:         ~
                search_dn:            ''
                search_password:      ''
            remember_me:
                secret:               ~ # Required
                service:              ~
                user_providers:       []
                catch_exceptions:     true

                # An array of properties on your User that are used to sign the remember-me cookie. If any of these change, all existing cookies will become invalid.
                signature_properties:

                    # Examples:
                    - email
                    - password
                token_provider:

                    # The service ID of a custom rememberme token provider.
                    service:              ~
                    doctrine:
                        enabled:              false
                        connection:           null

                # The service ID of a custom rememberme token verifier.
                token_verifier:       ~
                name:                 REMEMBERME
                lifetime:             31536000
                path:                 /
                domain:               null
                secure:               false # One of true; false; "auto"
                httponly:             true
                samesite:             null # One of null; "lax"; "strict"; "none"
                always_remember_me:   false
                remember_me_parameter: _remember_me
            anonymous:
                lazy:                 false # Deprecated (Since symfony/security-bundle 5.1: Using "anonymous: lazy" to make the firewall lazy is deprecated, use "anonymous: true" and "lazy: true" instead.)
                secret:               null
    access_control:

        # Prototype
        -
            requires_channel:     null

            # use the urldecoded format
            path:                 null # Example: '^/path to resource/'
            host:                 null
            port:                 null
            ips:                  []
            methods:              []
            allow_if:             null
            roles:                []
    role_hierarchy:

        # Prototype
        id:                   []

bash-3.2$ 
bash-3.2$  php bin/console debug:config security

[33mIn ArrayNode.php line 218:[39m
[37;41m                                                                     [39;49m
[37;41m  The child config "firewalls" under "security" must be configured.  [39;49m
[37;41m                                                                     [39;49m

[32mdebug:config [<name> [<path>]][39m

bash-3.2$  php bin/console debug:config security[9@config:dump-reference[C[C[C[C[C[C[C[C[C[C[C[C[C[C[C[C[C[C[C[7Pcomposer require symfony/security-bundle[C[C[C[C[C[C[C[C[C[C php bin/console doctrine:migrations:migrate[C[C[C[C[C[C[C[C[C[C[C[17Pbin/console make:migration[C[C[C[C[C[C[C[C[C[C[4Pbin/console make:entity[C[C[C[C[C[C[C[C[C[C[12Pmake:entity php bin/console make:user[C[C[C[C[C[C[C[C[C[C[1Pcomposer require security[C[C[C[C[C[C[C[C[C[CLS[Kcd pruebaNivel/[C[C[C[C[C[C[C[C[C[Cls[Kcleard ..[2Pls[1Plscomposer require symfony/apache-pack[C[C[C[C[C[C[C[C[C[Cls[Kphp -S localhost:8080 -t public/[C[C[C[C[C[C[C[C[C[C[C[C[C[C[Cs[C[C[C[C[C[C[C[C[C[C[C[C[C[C[C[C[C[C[C[C[C[C[C[C[C[C[K[C[C[C[C[C[C[C[C[C[Cbin/console doctrine:database:importexecute[1Pimport[K[C[C[C[C[C[C[C[C[C[C[12Pdoctrinebin/console doctrine:database:create[C[C[C[C[C[C[C[C[C[C[Crew mysql[K[1Plhomebrew mysql[C[C[C[C[C[C[C[C[C[Csymfony open:localserver:start -d[C[C[C[C[C[C[C[C[C[Cbin/console make:controller [C[C[C[C[C[C[C[C[C[C[1Pcomposer req profiler --devuire symfony/apache-pack[C[C[C[C[C[C[C[C[C[C[C[21Pd pruebaNivel/[C[C[C[C[C[C[C[C[C[C[Composer require symfony/apache-pack[C[C[C[C[C[C[C[C[C[C[C[C[C[C[C[C[C[C[Ccreate-project symfony/website-skeleton pruebaNivel[C[C[C[C[C[C[C[C[C[C[Clear[K[3Plscd /Users/aida/.bitnami/stackman/machines/xampp/volumes/root/htdocs/PruebaNivel[C[C[C[C[C[C[C[C[C[C[C[C..[K ..[3Pls..lscd ..[3Plscomposer create-project symfony/website-skeleton pruebaNivel[C[C[C[C[C[C[C[C[C[C[C[C[C[C[C[C[C[C[C[33Preq profiler --dev[C[C[C[C[C[C[C[C[C[C[9Psymfony open:localserver:start -d[C[C[C[C[C[C[C[C[C[Cls[Ksymfony server:start -d[C[C[C[C[C[C[C[C[C[Cls[Kcomposer require symfony/apache-pack[C[C[C[C[C[C[C[C[C[C[C[21Pd pruebaNivel/[C[C[C[C[C[C[C[C[C[Cls[Kcd pruebaNivel/[C[C[C[C[C[C[C[C[C[C[Composer require symfony/apache-pack[C[C[C[C[C[C[C[C[C[C[C[21Pd pruebaNivel/[C[C[C[C[C[C[C[C[C[Cls[Kcomposer require symfony/apache-pack[C[C[C[C[C[C[C[C[C[C[C[C[C[C[C[C[C[C[Ccreate-project symfony/website-skeleton pruebaNivel[C[C[C[C[C[C[C[C[C[Cls[Kclear
[H[2Jbash-3.2$ bin/console  make:auth 

 [32mWhat style of authentication do you want?[39m [[33mEmpty authenticator[39m]:
  [[33m0[39m] Empty authenticator
  [[33m1[39m] Login form authenticator
 > 1[K


[37;41m                                                                                                                        [39;49m
[37;41m [ERROR] To generate a form login authentication, you must configure at least one entry under "providers" in            [39;49m
[37;41m         "security.yaml".                                                                                               [39;49m
[37;41m                                                                                                                        [39;49m

bash-3.2$ clear
[H[2Jbash-3.2$ clearbin/console  make:auth 

[37;41m                                                                                                                        [39;49m
[37;41m [ERROR] The file "config/packages/security.yaml" does not exist. This command requires that file to exist so that it   [39;49m
[37;41m         can be updated.                                                                                                [39;49m
[37;41m                                                                                                                        [39;49m

bash-3.2$ bin/console  make:auth 

[33mIn YamlSourceManipulator.php line 59:[39m
[37;41m                                                           [39;49m
[37;41m  Only YAML with a top-level array structure is supported  [39;49m
[37;41m                                                           [39;49m

[32mmake:auth[39m

bash-3.2$ bin/console  make:auth [K[K[K[K[K[K[K[K[K[K[Kcomposer require symfony/security-bundle

[37;41m                                      [39;49m
[37;41m  Command "composer" is not defined.  [39;49m
[37;41m                                      [39;49m

bash-3.2$ bin/console composer require symfony/security-bundle[1P[1P[1P[1P[1P[1P[1P[1P[1P[1P[C[1P
[32m./composer.json has been updated[39m
[32mRunning composer update symfony/security-bundle[39m
[32mLoading composer repositories with package information[39m
[32mUpdating dependencies[39m
Nothing to modify in lock file
[32mInstalling dependencies from lock file (including require-dev)[39m
Nothing to install, update or remove
[32mGenerating optimized autoload files[39m
[32mcomposer/package-versions-deprecated:[39m Generating version class...
[32mcomposer/package-versions-deprecated:[39m ...done generating version class
[32m110 packages you are using are looking for funding.[39m
[32mUse the `composer fund` command to find out more![39m

Run [33mcomposer recipes[39m at any time to see the status of your Symfony recipes.

Executing script cache:clear [32m[OK][39m
Executing script assets:install public [32m[OK][39m

bash-3.2$  composer require symfony/security-bundle[C[C[C[C[C[C[C[C[C[C[11@bin/console[C[C[C[C[C[C[C[C[C[C[C[C[C[C[C[C[C[C[C[C[C[C[C[C[C[C[C[C[C[C[C[C[C[C[C[C[C[C[C[C[C[C[C[C[C[C[C[C[C[C[C[C[C[C[C[C[C[C[C[C[C[C[C make:auth [K

[33mIn YamlSourceManipulator.php line 59:[39m
[37;41m                                                           [39;49m
[37;41m  Only YAML with a top-level array structure is supported  [39;49m
[37;41m                                                           [39;49m

[32mmake:auth[39m

bash-3.2$ bin/console  make:auth 

[33mIn ArrayNode.php line 218:[39m
[37;41m                                                                     [39;49m
[37;41m  The child config "firewalls" under "security" must be configured.  [39;49m
[37;41m                                                                     [39;49m

bash-3.2$ bin/console make:user

[33mIn ArrayNode.php line 218:[39m
[37;41m                                                                     [39;49m
[37;41m  The child config "firewalls" under "security" must be configured.  [39;49m
[37;41m                                                                     [39;49m

bash-3.2$ bin/console make:user

[33mIn ArrayNode.php line 218:[39m
[37;41m                                                                     [39;49m
[37;41m  The child config "firewalls" under "security" must be configured.  [39;49m
[37;41m                                                                     [39;49m

bash-3.2$ clear
[H[2Jbash-3.2$ clearbin/console make:user

[33mIn AnonymousFactory.php line 52:[39m
[37;41m                                                                                                                      [39;49m
[37;41m  The authenticator manager no longer has "anonymous" security. Please remove this option under the "main" firewall.  [39;49m
[37;41m                                                                                                                      [39;49m

bash-3.2$ bin/console make:user[C[C[C[C[C[C[C[C[C[Cclear[Kbin/console make:user

 [32mThe name of the security user class (e.g. [39m[33mUser[39m[32m)[39m [[33mUser[39m]:
 > User    

 [32mDo you want to store user data in the database (via Doctrine)? (yes/no)[39m [[33myes[39m]:
 > yes

 [32mEnter a property name that will be the unique "display" name for the user (e.g. [39m[33memail, username, uuid[39m[32m)[39m [[33memail[39m]:
 > email

 Will this app need to hash/check user passwords? Choose [33mNo[39m if passwords are not needed or will be checked/hashed by some other system (e.g. a single sign-on server).

 [32mDoes this app need to hash/check user passwords? (yes/no)[39m [[33myes[39m]:
 > 


[37;41m                                                                                                                        [39;49m
[37;41m [ERROR] The file "src/Entity/User.php" can't be generated because it already exists.                                   [39;49m
[37;41m                                                                                                                        [39;49m

bash-3.2$ bin/console make:user[C[C[C[C[C[C[C[C[C[Cclear[Kbin/console make:user make:auth 

 [32mWhat style of authentication do you want?[39m [[33mEmpty authenticator[39m]:
  [[33m0[39m] Empty authenticator
  [[33m1[39m] Login form authenticator
 > 1[K

 [32mThe class name of the authenticator to create (e.g. [39m[33mAppCustomAuthenticator[39m[32m)[39m:
 > LoginFormAuthenticator

 [32mChoose a name for the controller class (e.g. [39m[33mSecurityController[39m[32m)[39m [[33mSecurityController[39m]:
 > SecurityController

 [32mDo you want to generate a '/logout' URL? (yes/no)[39m [[33myes[39m]:
 > yes

 [34mcreated[39m: src/Security/LoginFormAuthenticator.php
 [33mupdated[39m: config/packages/security.yaml
 [34mcreated[39m: src/Controller/SecurityController.php
 [34mcreated[39m: templates/security/login.html.twig

 [37;42m          [39;49m
 [37;42m Success! [39;49m
 [37;42m          [39;49m

 Next:
 - Customize your new authenticator.
 - Finish the redirect "TODO" in the [32mApp\Security\LoginFormAuthenticator::onAuthenticationSuccess()[39m method.
 - Check the user's password in [32mApp\Security\LoginFormAuthenticator::checkCredentials()[39m.
 - Review & adapt the login template: [32mtemplates/security/login.html.twig[39m.
bash-3.2$ php bin/console doctrine:schema:update --force

[30;42m                                                                                                                        [39;49m
[30;42m [OK] Nothing to update - your database is already in sync with the current entity metadata.                            [39;49m
[30;42m                                                                                                                        [39;49m

bash-3.2$ php bin/console security:encode-password MyTestPassword


[37;41m !                                                                                                                      [39;49m
[37;41m ! [CAUTION] The use of the "security:encode-password" command is deprecated since version 5.3 and will be removed in   [39;49m
[37;41m !           6.0. Use "security:hash-password" instead.                                                                 [39;49m
[37;41m !                                                                                                                      [39;49m

[33mSymfony Password Encoder Utility[39m
[33m================================[39m


[37;41m                                                                  [39;49m
[37;41m  There are no configured encoders for the "security" extension.  [39;49m
[37;41m                                                                  [39;49m

[32msecurity:encode-password [--empty-salt] [--] [<password> [<user-class>]][39m

bash-3.2$ 
bash-3.2$ php bin/console security:encode-password MyTestPassword[K[K[K[K[K[K[K[K[K[K[K[K[K[K[K[K[K[K[K[K[K[K[K[K[K[K[K[K[K[K[K[K[K[K[K[K[K[K[K[K security:hash-password

[33mSymfony Password Hash Utility[39m
[33m=============================[39m


[37;41m                                                                          [39;49m
[37;41m  There are no configured password hashers for the "security" extension.  [39;49m
[37;41m                                                                          [39;49m

[32msecurity:hash-password [--empty-salt] [--] [<password> [<user-class>]][39m

bash-3.2$ php bin/console security:hash-password [K[K[K[K[K[K[K[K[K[K[K[K[K[K[K[K[K[K[K[K[K[K[K[K[K[K[K[K[K[K[K[K[K[K[K[K[K[K[Kclear
[H[2Jbash-3.2$ composer require symfony/apache-pack
Using version [32m^1.0[39m for [32msymfony/apache-pack[39m
[32m./composer.json has been updated[39m
[32mRunning composer update symfony/apache-pack[39m
[32mLoading composer repositories with package information[39m
[32mUpdating dependencies[39m
Nothing to modify in lock file
[32mInstalling dependencies from lock file (including require-dev)[39m
Nothing to install, update or remove
[32mGenerating optimized autoload files[39m
[32mcomposer/package-versions-deprecated:[39m Generating version class...
[32mcomposer/package-versions-deprecated:[39m ...done generating version class
[32m110 packages you are using are looking for funding.[39m
[32mUse the `composer fund` command to find out more![39m

Run [33mcomposer recipes[39m at any time to see the status of your Symfony recipes.

Executing script cache:clear [32m[OK][39m
Executing script assets:install public [32m[OK][39m

bash-3.2$ bin/console make:fixtures

[37;41m                                                                                                                        [39;49m
[37;41m [ERROR] Missing package: to use the make:fixtures command, run:                                                        [39;49m
[37;41m                                                                                                                        [39;49m
[37;41m         composer require orm-fixtures --dev                                                                            [39;49m
[37;41m                                                                                                                        [39;49m

bash-3.2$ composer require orm-fixtures --dev  
Using version [32m^3.4[39m for [32mdoctrine/doctrine-fixtures-bundle[39m
[32m./composer.json has been updated[39m
[32mRunning composer update doctrine/doctrine-fixtures-bundle[39m
[32mLoading composer repositories with package information[39m
[32mUpdating dependencies[39m
[32mLock file operations: 2 installs, 0 updates, 0 removals[39m
  - Locking [32mdoctrine/data-fixtures[39m ([33m1.5.0[39m)
  - Locking [32mdoctrine/doctrine-fixtures-bundle[39m ([33m3.4.0[39m)
[32mWriting lock file[39m
[32mInstalling dependencies from lock file (including require-dev)[39m
[32mPackage operations: 2 installs, 0 updates, 0 removals[39m
  - Downloading [32mdoctrine/data-fixtures[39m ([33m1.5.0[39m)
  - Downloading [32mdoctrine/doctrine-fixtures-bundle[39m ([33m3.4.0[39m)
 0/2 [>---------------------------]   0%[2K 1/2 [==============>-------------]  50%[2K 2/2 [============================] 100%[2K  - Installing [32mdoctrine/data-fixtures[39m ([33m1.5.0[39m): Extracting archive
  - Installing [32mdoctrine/doctrine-fixtures-bundle[39m ([33m3.4.0[39m): Extracting archive
 0/2 [>---------------------------]   0%[2K 1/2 [==============>-------------]  50%[2K 2/2 [============================] 100%[2K 2/2 [============================] 100%[2K[32mGenerating optimized autoload files[39m
[32mcomposer/package-versions-deprecated:[39m Generating version class...
[32mcomposer/package-versions-deprecated:[39m ...done generating version class
[32m112 packages you are using are looking for funding.[39m
[32mUse the `composer fund` command to find out more![39m

[32mSymfony operations: 1 recipe (9c9391dfa1c166944a79b8c70bbdc2b2)[39m
  - Configuring [32mdoctrine/doctrine-fixtures-bundle[39m ([33m>=3.0[39m): From github.com/symfony/recipes:master
Executing script cache:clear [32m[OK][39m
Executing script assets:install public [32m[OK][39m
[37;44m              [39;49m
[37;44m What's next? [39;49m
[37;44m              [39;49m

[32mSome files have been created and/or updated to configure your new packages.[39m
Please [33mreview[39m, [33medit[39m and [33mcommit[39m them: these files are [33myours[39m.

bash-3.2$ composer require orm-fixtures --dev  [C[C[C[C[C[C[C[C[C[C[12Pbin/console make:fixtures[C[C[C[C[C[C[C[C[C[Ccomposer require symfony/apache-pack[C[C[C[C[C[C[C[C[C[C[Clear[Kphp bin/console security:hash-passwordencode-password MyTestPassword[17Phash-password

[33mSymfony Password Hash Utility[39m
[33m=============================[39m

 [32mType in your password to be hashed[39m:
 > 